=########=
##XC  CC## 
# C C CC #
#CC  CCC #
#CC C C C#
# C BC C #
#     C C#
#C P   MC#
##%   CE##
=###  ###=
