=########=
##XC  CC## 
# C C CC #
#CC  CCC #
#CC C C C#
# C BC C #
# CC  C C#
#C C   CC#
##C   CE##
=###  ###=
