=########=
##XC  CC## 
# C C CC #
#CC  CCC #
#CC C C C#
# C CC C #
# CC  C C#
#C CC BCC#
##C C CE##
=########=
