=########=
##XC  CC## 
# C C CC #
#TC  CCC #
#CC C C C#
# C BC C #
#     T C#
#   C  MC#
##  OP E##
=###==###=
